<?xml version="1.0"?>
<Level xmlns:xsi="http://www.w3.org/2001/XMLSchema-instance" xmlns:xsd="http://www.w3.org/2001/XMLSchema">
  <MapDimensions>
    <X>32</X>
    <Y>32</Y>
  </MapDimensions>
  <MapName>map1</MapName>
  <Enemies>
    <Enemy xsi:type="Blob">
      <MapLocation>
        <X>64</X>
        <Y>64</Y>
      </MapLocation>
    </Enemy>
  </Enemies>
  <MapTransitions>
    <MapTransition>
      <TargetMap>map2.dat</TargetMap>
      <Rectangle>
        <X>0</X>
        <Y>2</Y>
        <Width>1</Width>
        <Height>3</Height>
        <Location>
          <X>0</X>
          <Y>2</Y>
        </Location>
      </Rectangle>
      <TransitionPath>1</TransitionPath>
      <Exit>true</Exit>
    </MapTransition>
    <MapTransition>
      <Rectangle>
        <X>1</X>
        <Y>3</Y>
        <Width>1</Width>
        <Height>1</Height>
        <Location>
          <X>1</X>
          <Y>3</Y>
        </Location>
      </Rectangle>
      <TransitionPath>2</TransitionPath>
      <Exit>false</Exit>
    </MapTransition>
  </MapTransitions>
  <SpriteMapAsString>3 3 3 3 3 3 3 3 3 3 3 3 3 3 3 3 3 3 3 3 3 3 3 3 3 3 3 3 3 3 3 3 
3 1 2 2 1 1 0 0 1 2 2 1 2 2 2 2 1 2 2 0 0 1 1 2 1 2 1 2 0 0 1 3 
0 2 0 0 1 0 1 1 2 1 1 2 0 1 2 1 1 0 0 0 1 2 1 2 1 0 0 0 1 2 2 3 
0 0 2 1 1 3 3 3 3 3 1 2 0 0 2 0 0 0 0 2 1 0 2 2 2 2 1 1 1 0 0 3 
0 0 0 0 0 3 4 4 4 3 3 2 2 0 2 1 1 0 0 1 0 2 0 1 1 2 1 2 1 1 1 3 
3 0 2 0 2 3 4 4 4 4 3 0 0 0 2 1 0 1 0 0 0 0 0 0 0 0 2 2 2 2 2 3 
3 0 1 1 1 3 4 4 4 4 3 1 1 2 0 2 2 0 2 2 1 0 1 0 0 0 2 2 2 2 0 3 
3 2 1 2 2 3 3 4 3 3 3 1 0 2 1 2 1 1 0 0 0 2 2 2 0 2 1 0 0 0 0 3 
3 0 2 1 0 2 0 2 0 0 0 1 1 0 0 2 2 2 2 1 2 1 2 1 1 1 2 1 1 2 1 3 
3 1 0 0 1 1 1 1 1 1 1 2 1 2 0 2 0 2 1 1 2 1 0 1 1 2 1 0 0 2 2 3 
3 2 0 0 1 1 0 0 1 2 0 0 1 1 0 2 2 2 1 2 0 0 2 0 0 0 1 2 2 2 0 3 
3 0 1 2 1 2 2 1 1 1 1 2 0 2 0 1 0 1 1 2 2 2 2 0 1 2 2 2 0 1 2 3 
3 1 1 1 2 2 2 1 0 1 2 1 0 2 0 0 2 0 0 1 2 0 1 0 0 1 1 1 0 1 0 3 
3 0 1 0 2 0 1 1 0 0 2 2 0 0 2 0 1 0 2 0 2 1 1 1 1 2 2 1 1 0 1 3 
3 1 0 1 1 2 0 0 0 2 2 0 0 0 1 0 2 1 0 0 2 1 1 0 2 1 1 2 1 2 0 3 
3 2 0 2 1 1 1 2 2 2 2 1 2 0 0 1 0 1 0 1 0 1 0 0 1 0 2 0 2 2 1 3 
3 1 1 0 1 0 0 1 1 2 1 0 1 1 0 1 1 1 2 0 0 2 1 0 1 2 2 2 0 1 2 3 
3 1 2 2 0 0 0 1 1 0 1 2 0 0 2 0 2 1 2 2 2 1 0 2 1 2 0 0 2 2 0 3 
3 0 0 2 0 0 0 2 0 0 1 2 2 2 1 1 1 0 0 1 2 0 2 0 2 0 0 2 0 1 0 3 
3 2 2 1 2 0 1 0 0 2 2 0 0 2 1 2 2 1 0 0 0 2 2 0 0 0 1 2 0 0 2 3 
3 0 1 2 2 1 2 1 2 0 2 1 0 1 2 1 2 2 2 2 1 2 2 0 1 1 2 2 0 2 2 3 
3 1 0 2 2 1 2 1 0 0 0 1 2 2 1 2 1 1 1 2 1 1 0 1 2 2 1 1 1 1 1 3 
3 2 0 2 1 0 1 0 1 0 2 0 2 1 1 0 0 2 1 2 2 1 1 1 1 1 1 1 0 0 0 3 
3 0 0 1 1 0 0 2 1 0 1 1 2 0 2 0 1 1 2 1 2 2 2 1 1 0 1 1 1 0 2 3 
3 2 2 1 0 1 0 0 0 1 2 1 0 0 1 1 2 0 1 1 2 2 2 2 0 0 0 1 0 0 2 3 
3 2 0 1 1 1 1 0 0 1 2 0 0 1 2 1 1 1 0 0 1 1 2 0 0 2 2 0 1 2 0 3 
3 1 0 2 2 0 0 2 1 2 2 1 2 0 1 1 1 1 2 2 2 2 0 2 2 1 2 0 0 2 1 3 
3 1 2 1 0 0 2 1 2 2 0 2 2 1 0 2 1 2 2 2 0 1 1 1 2 1 0 1 0 0 0 3 
3 0 1 2 0 1 2 0 2 0 1 0 1 0 2 2 2 2 1 0 2 2 1 1 2 0 2 1 1 1 2 3 
3 1 0 1 1 0 1 0 1 2 0 0 2 1 0 2 2 1 1 0 2 1 2 0 1 0 2 2 0 0 1 3 
3 0 2 1 0 2 2 0 1 2 1 1 1 2 2 2 0 2 1 2 0 1 2 1 2 1 2 0 2 1 1 3 
3 3 3 3 3 3 3 3 3 3 3 3 3 3 3 3 3 3 3 3 3 3 3 3 3 3 3 3 3 3 3 3 
</SpriteMapAsString>
</Level>