<?xml version="1.0"?>
<Level xmlns:xsi="http://www.w3.org/2001/XMLSchema-instance" xmlns:xsd="http://www.w3.org/2001/XMLSchema">
  <MapDimensions>
    <X>32</X>
    <Y>32</Y>
  </MapDimensions>
  <MapName>map2</MapName>
  <MapTransitions>
    <MapTransition>
      <TargetMap>map2.dat</TargetMap>
      <TransitionPath>1</TransitionPath>
      <Exit>false</Exit>
      <Rectangle>
        <X>30</X>
        <Y>23</Y>
        <Width>1</Width>
        <Height>1</Height>
        <Location>
          <X>30</X>
          <Y>23</Y>
        </Location>
      </Rectangle>
    </MapTransition>
    <MapTransition>
      <TargetMap>map1.dat</TargetMap>
      <TransitionPath>2</TransitionPath>
      <Exit>true</Exit>
      <Rectangle>
        <X>31</X>
        <Y>22</Y>
        <Width>2</Width>
        <Height>3</Height>
        <Location>
          <X>31</X>
          <Y>22</Y>
        </Location>
      </Rectangle>
    </MapTransition>
  </MapTransitions>
  <SpriteMapAsString>3 3 3 3 3 3 3 3 3 3 3 3 3 3 3 3 3 3 3 3 3 3 3 3 3 3 3 3 3 3 3 3 
3 1 2 2 1 1 0 0 1 2 2 1 2 2 2 2 1 2 2 0 0 1 1 2 1 2 1 2 0 0 1 3 
3 2 0 0 1 0 1 1 2 1 1 2 0 1 2 1 1 0 0 0 1 2 1 2 1 0 0 0 1 2 2 3 
3 0 2 1 1 2 1 1 1 2 1 2 0 0 2 0 0 0 0 2 1 0 2 2 2 2 1 1 1 0 0 3 
3 0 0 0 1 0 2 2 0 2 0 2 2 0 2 1 1 0 0 1 0 2 0 1 1 2 1 2 1 1 1 3 
3 0 2 0 2 0 1 0 2 1 0 0 0 0 2 1 0 1 0 0 0 0 0 0 0 0 2 2 2 2 2 3 
3 0 1 1 1 0 2 2 1 1 2 1 1 2 0 2 2 0 2 2 1 0 1 0 0 0 2 2 2 2 0 3 
3 2 1 2 2 0 2 1 1 2 1 1 0 2 1 2 1 1 0 0 0 2 2 2 0 2 1 0 0 0 0 3 
3 0 2 1 0 2 0 2 0 0 0 1 1 0 0 2 2 2 2 1 2 1 2 1 1 1 2 1 1 2 1 3 
3 1 0 0 1 1 1 1 1 1 1 2 1 2 0 2 0 2 1 1 2 1 0 1 1 2 1 0 0 2 2 3 
3 2 0 0 1 1 0 0 1 2 0 0 1 1 0 2 2 2 1 2 0 0 2 0 0 0 1 2 2 2 0 3 
3 0 1 2 1 2 2 1 1 1 1 2 0 2 0 1 0 1 1 2 2 2 2 0 1 2 2 2 0 1 2 3 
3 1 1 1 2 2 2 1 0 1 2 1 0 2 0 0 2 0 0 1 2 0 1 0 0 1 1 1 0 1 0 3 
3 0 1 0 2 0 1 1 0 0 2 2 0 0 2 0 1 0 2 0 2 1 1 1 1 2 2 1 1 0 1 3 
3 1 0 1 1 2 0 0 0 2 2 0 0 0 1 0 2 1 0 0 2 1 1 0 2 1 1 2 1 2 0 3 
3 2 0 2 1 1 1 2 2 2 2 1 2 0 0 1 0 1 0 1 0 1 0 0 1 0 2 0 2 2 1 3 
3 1 1 0 1 0 0 1 1 2 1 0 1 1 0 1 1 1 2 0 0 2 1 0 1 2 2 2 0 1 2 3 
3 1 2 2 0 0 0 1 1 0 1 2 0 0 2 0 2 1 2 2 2 1 0 2 1 2 0 0 2 2 0 3 
3 0 0 2 0 0 0 2 0 0 1 2 2 2 1 1 1 0 0 1 2 0 2 0 2 0 0 2 0 1 0 3 
3 2 2 1 2 0 1 0 0 2 2 0 0 2 1 2 2 1 0 0 0 2 2 0 0 0 1 2 0 0 2 3 
3 0 1 2 2 1 2 1 2 0 2 1 0 1 2 1 2 2 2 2 1 2 2 0 1 1 2 2 0 2 2 3 
3 1 0 2 2 1 2 1 0 0 0 1 2 2 1 2 1 1 1 2 1 1 0 1 2 2 1 1 1 1 1 3 
3 2 0 2 1 0 1 0 1 0 2 0 2 1 1 0 0 2 1 2 2 1 1 1 1 1 1 1 0 0 0 0 
3 0 0 1 1 0 0 2 1 0 1 1 2 0 2 0 1 1 2 1 2 2 2 1 1 0 1 1 1 0 0 2 
3 2 2 1 0 1 0 0 0 1 2 1 0 0 1 1 2 0 1 1 2 2 2 2 0 0 0 1 0 0 2 1 
3 2 0 1 1 1 1 0 0 1 2 0 0 1 2 1 1 1 0 0 1 1 2 0 0 2 2 0 1 2 0 3 
3 1 0 2 2 0 0 2 1 2 2 1 2 0 1 1 1 1 2 2 2 2 0 2 2 1 2 0 0 2 1 3 
3 1 2 1 0 0 2 1 2 2 0 2 2 1 0 2 1 2 2 2 0 1 1 1 2 1 0 1 0 0 0 3 
3 0 1 2 0 1 2 0 2 0 1 0 1 0 2 2 2 2 1 0 2 2 1 1 2 0 2 1 1 1 2 3 
3 1 0 1 1 0 1 0 1 2 0 0 2 1 0 2 2 1 1 0 2 1 2 0 1 0 2 2 0 0 1 3 
3 0 2 1 0 2 2 0 1 2 1 1 1 2 2 2 0 2 1 2 0 1 2 1 2 1 2 0 2 1 1 3 
3 3 3 3 3 3 3 3 3 3 3 3 3 3 3 3 3 3 3 3 3 3 3 3 3 3 3 3 3 3 3 3 
</SpriteMapAsString>
</Level>